9 8
Wall 0 0 2
Wall 0 0 3
Wall 0 0 4
Wall 0 0 5
Wall 0 0 6
Wall 0 1 0
Wall 0 1 1
Wall 0 1 2
Wall 0 1 6
Wall 0 2 0
None 1 2 1
Keeper 0 2 2
Box 0 2 3
Wall 0 2 6
Wall 0 3 0
Wall 0 3 1
Wall 0 3 2
Box 0 3 4
None 1 3 5
Wall 0 3 6
Wall 0 4 0
None 1 4 1
Wall 0 4 2
Wall 0 4 3
Box 0 4 4
Wall 0 4 6
Wall 0 5 0
Wall 0 5 2
None 1 5 4
Wall 0 5 6
Wall 0 5 7
Wall 0 6 0
Box 0 6 1
Box 1 6 3
Box 0 6 4
Box 0 6 5
None 1 6 6
Wall 0 6 7
Wall 0 7 0
None 1 7 4
Wall 0 7 7
Wall 0 8 0
Wall 0 8 1
Wall 0 8 2
Wall 0 8 3
Wall 0 8 4
Wall 0 8 5
Wall 0 8 6
Wall 0 8 7
